XXXXXXXXXXXXXXXXXXX
X          X*X    X
X    +     X X +7 X
X   XXXX   X @    X
X   @  X@@@X @    X
XX@@@        @@X  X
X*             X  X
XXXXX         XX  X
X   @    S    @   X
X 7 @         @ + X
X   @         @   X
X  XX         XXXXX
X  X             *X
X  X@@       @@@XXX
X    @ X@@@X @    X
X  + @ X 7 XXX    X
XX   X X +      + X
X    X*X          X
XXXXXXXXXXXXXXXXXXX