XXXXXXXXXXXXXXXXX
X               X
X    # O@O #    X
X  + #  @  # +  X
X     O * O     X
X               X
X@@@XXX@@@XXX@@@X
X    *X   X*    X
X     X   X     X
XXXX  X   X  XXXX
X               X
X       S       X
X               X
XXXXXXXXXXXXXXXXX