XXXXXXXXXXX
X   #  #  X
X+  #     X
X# ##  + #X
X         X
X## O O ##X
X## #*# ##X
X## ### ##X
X        0X
XXXXX XXXXX
XXXXX XXXXX
XXXX   XXXX
XXXX S XXXX
XXXXXXXXXXX