XXXXXXXXXXXXXXXXXX
X        @       X
X + XX + @       X
X        @  +    X
X ##O ## @    O  X
X        #       X
X @@  @@ #  4    X
X        # XXX O X
X *#  #* # X     X
X        #    @  X
X ##  ## @ * @@  X
X        @       X
X @@ O   @       X
X           XXXXXX
XXXXXXX     XXXXXX
XXXXXXX     XXXXXX
XXXXXXXX@@@XXXXXXX
XXXXXXXX S XXXXXXX
XXXXXXXX   XXXXXXX
XXXXXXXXXXXXXXXXXX