XXXXXXXXXXXXXXXXXXX
X    X* @    X    X
X       @    X +  X
X S     @ O  X    X
X    X  #    @  @ X
XXXXXX  #@@@ @  @ X
X**XXX  #    X    X
X**  3 #O + X##  X
XXXXXX       XO   X
XXXXXXXX  XXXX    X
XXXXXX            X
XXXXXX ###   7  @@X
XXXXXX #3# O    * X
XXXXXX            X
XXXXXX          # X
XXXXXX            X
XXXXXX +O ##  @@+ X
XXXXXX        @@O X
XXXXXXXXXXXXXXXXXXX