XXXXXXXXXXX
X    *    X
X @@   ## X
X @     # X
X         X
X    +    X
X      O  X
X @     # X
X @O   ## X
X         X
X         X
XXX     XXX
XXX     XXX
XXX     XXX
XX*     *XX
XX   S   XX
XX       XX
XXXXXXXXXXX