XXXXXXXXXXXXX
X    @     XX
X    @     XX
X  + @ @@@ XX
X ##O@     XX
X    X   + XX
X    XXXXXXXX
X   *XXXX   X
X   XXXXX S X
X@@@XXXXX   X
X     O     X
X @   2   # X
X   *       X
XXXXXXXXXXXXX