XXXXXXXXXXXXXXXXX
XXXXX *  ### O  X
X   @      @    X
X S @      @  + X
X   @      @    X
XXXXX# ##### *  X
XXXXXXXXXXXXXXXXX